NUM	NUM	TEXT	NUM	NUM
类型	每次创建数量	创建函数	种子补充间隔	补充时间的随机增量
106	1		1		
107	1		1	
108	1		1	
109	1		1	
111	1		10000	
112	1		1	
113	1		1	
114	1		-1	