NUM	NUM	TEXT	NUM	NUM
类型	每次创建数量	创建函数	种子补充间隔	补充时间的随机增量
910	1		-1	
911	1		-1	
912	1		-1	
913	1		-1	
914	1		-1	
915	1		-1	
916	1		-1	
917	1		-1	
918	1		-1	
919	1		-1	
920	1		-1	
921	1		-1	
922	1		-1	
923	1		-1	
924	1		-1	
