NUM	NUM	TEXT	NUM	NUM
类型	每次创建数量	创建函数	种子补充间隔	补充时间的随机增量
840	1		-1	
841	1		-1	
842	1		-1	
843	1		-1	
844	1		-1	
845	1		-1	
846	1		-1	
847	1		-1	
848	1		-1	
849	1		-1	
850	1		-1	
851	1		-1	
852	1		-1	
853	1		-1	
854	1		-1
855	1		-1
856	1		-1
857	1		-1
